to regulate - regulować
sensor - czujnik
detector - wykrywacz
activate - aktywować
controller - sterownik
thermostat - termostat
remote control - pilot do odbiornika
valve - zawór
parking sensor - czujnik parkowania
humidity sensor - czujnik wilgotności
electrical charge - ładunek elektryczny
security quard - ochroniarz
off_peak period - czas poza szczytem
smoke detector - wykrywacz dymu
blinds controller - sterownik do rolet
security system - system alarmowy
manual - ręczny
measurement - pomiar
hygrometer - higrometr
seismometer - sejsmograf
characteristic - charakterystyka
tactile sensor - czujnik dotykowy
assumption - przypuszczenie
to set off - uruchomić
to plant - zasadzić
to operate - obsługiwać
air_conditioning - klimatyzacja
gizmo - ustrojstwo
gsimo - gadżet
reading - odczyt/pomiar
to adjust - wyregulować
to trigger - aktywować
lie detector - wykrywacz kłamstw
open_plan office - biuro bez ścianek działowych
radiator - kaloryfer
off the top of my head - bez zastanowienia
to take into account - brać pod uwagę
switch - przełącznik
complaint- reklamacja
controller - sterownik
store room - magazyn
to appreciate - docenić
to sense - wyczuć
to detect - wykryć
to circulate - rozesłać
blinds - rolety
to automate - zautomatyzować
to limit - ograniczyć
radiation - promieniowanie
absorption - absorpcja
vessel - zbiornik/pojemnik
a peak - szczyt
to emphasise - podkreślić
