frequency - częstotliwość
cycle - cykl
washing machine - pralka
to set - ustawić
optimal - optymalny
maximal - maksymalny
minimal - minimalny
fridge - lodówka
review - przegląd
to disregard - zignorować/lekceważyć
precuation - zpobiegawczy
unproductive - bezproduktywny
occur - zdarzyć się/wystąpić
level - poziom
domestic - domowy/krajowy
pipe - rura
to affect - wpływać na
continuous - ciągły
constant - stały
conveyor belt - przenośnik taśmowy
approach - podejście
interior - wnętrze/wewnętrzny
lighting - oświetlenie
corridor - korytarz
hand dryer - suszarka do rąk
switch off - wyłączyć
switch on - włączyć
speedometer - prędkościomierz
current - prąd
gravity - grawitacja
to obtain - otrzymać
blockage - blokada
badge - plakietka/identyfikator
grid - sieć energetyczna
to modify - modyfikować
competence - kompetencja
basement - piwnica
threshold - próg
ceiling - sufit
warmth - ciepło
circuit - obwód elektryczny
washbasin - umywalka
sink - zlew
shift - zmiana
vault - skarbiec
to require - potrzebować/wymagać
absorb - pochłaniać
liquid - ciecz
significant - znaczący
upper - wyższy
coal - węgiel
extensive - obszerny
on the contrary - wprost przeciwnie
